##############################
##############################
##            ##            ##
## #### ##### ## ##### #### ##
## #  # #   # ## #   # #  # ##
## #### ##### ## ##### #### ##
##                          ##
## #### ## ######## ## #### ##
## #### ## ######## ## #### ##
##      ##    ##    ##      ##
####### ##### ## ##### #######
#     # ##### ## ##### #     #
#     # ##          ## #     #
#     # ## ###  ### ## #     #
####### ## #G     # ## #######
           #      #
####### ## #      # ## #######
#     # ## ######## ## #     #
#     # ##          ## #     #
#     # ## ######## ## #     #
####### ## ######## ## #######
##            ##            ##
## #### ##### ## ##### #### ##
## #### ##### ## ##### #### ##
##   ##                ##   ##
#### ## ## ######## ## ## ####
#### ## ## ######## ## ## ####
##      ##    ##    ##      ##
## ########## ## ########## ##
##P########## ## ########## ##
##                          ##
##############################
##############################
